第05組-憤怒鳥

遊玩時建議使用build打包出的exe檔遊玩，否則會感覺畫面卡卡的，build檔位在同層的build資料夾

遊戲玩法:
WASD: 移動
Q: 開啟/關閉投擲畫面 
左鍵: 近距離投擲 
alt+左鍵: 遠距離投擲 
A/D: 在投擲畫面時移動左右角度，
滑鼠上下滑動: 在投擲畫面時可移動投擲仰角 
E: 靠近桌子時按會將當前投擲的鳥換成距離圖片最近的鳥 
ESC: 暫停
暫停:1.可選擇查看規則2.返回關卡選擇頁面3.調整音量4.重新開始此關卡5.繼續遊戲

憤怒鳥技能(按R釋放) :
炸彈鳥: 以鳥為中心產生爆炸 
黃鳥: 使鳥以一定速度向下前方俯衝 
白鳥: 下一顆可爆炸的蛋向下墜落並使鳥向上前方彈出 
藍鳥: 分裂出三隻藍鳥 
紅鳥: (不須按R)丟出後特效範圍內物體皆持續扣血及旋轉 
大紅鳥: (不須按R)第一個被碰撞的物體必定血量減少最大血量50% 

關卡分數計算: 
物件: 每一幀都會增加當前速度開根號的分數 
小豬: 死亡後增加100*體重的分數 
一星: 小豬全部死亡的分數 * 3 
二星: 小豬全部死亡的分數 * 4 
三星: 小豬全部死亡的分數 * 5 
通關規則: 所有小豬皆死亡或墜落即通關 
Bonus: 因應此門課喜歡+bonus的特性，關卡內房子血量若歸0或墜落會額外增加3000分

如何遊玩:
    遊戲開始時預設玩家是丟出小紅鳥，若玩家想換其他鳥可以找到桌子並靠近想替換的鳥的圖片按下E，右上角即會更換為當前所選的鳥，選定後按下Q進入投擲畫面，
滑鼠上下移動改變投擲仰角，鍵盤AD改變投擲方向，小豬全部死亡即可通關。

Script(詳細都有寫註解):
    Birdcommon: 作為憤怒鳥collider程式碼的繼承，主要處裡鳥高度過低時刪除的問題
    BirdFollow: 鳥飛出後控制相機切換至birdFollowCamera使視角跟著鳥移動
    *Collider: 處理碰撞、技能
    DrawParabola、Projection: 處理拋物線
    Stair: 處理人物上樓梯
    GameManger: 處理當前遊戲狀態
    Pig、PigDie: 處理小豬死亡反應、扣血及加分
    Prop: 處理物件碰撞、加分
    SceneSwitch: 畫面轉換
    islandCamera: 使視角轉換為俯瞰敵人島嶼
    level3Rotate: 讓第三關持續旋轉